Family and Relationships: aunt, baby, brother, daughter, father, friend, grandfather, grandmother, mother, sister, son, uncle
Colors: black, blue, brown, green, grey, orange, pink, purple, red, white, yellow
Numbers: eight, five, four, hundred, thousand
Nature: apple, autumn, bird, cloud, deer, earth, flower, forest, grass, rain, sky, snow, sun, tree, water, wind, beach, mountain, river, star, waterfall
Food and Drink: beer, bread, cheese, chicken, chocolate, coffee, cup, dinner, dish, drink, egg, fish, flour, food, fork, fruit, lunch, meal, milk, potato, rice, salt, sugar, tea
Feelings and Emotions: afraid, angry, anxious, happy, sad, surprised, excited, nervous, proud, confused
Time: ago, always, before, early, evening, future, morning, night, now, past, present, soon, today, tomorrow, yesterday
Time2: day, hour, minute, month, week, year
Objects and Items: bag, ball, book, box, chair, clock, coat, door, floor, hat, key, knife, pen, phone, ring, scissors, shoe, table, umbrella, window
Places and Locations: area, city, country, garden, home, house, room, school, street, town, village
Actions: act, add, bite, blow, boil, borrow, brush, build, catch, climb, close, cook, cry, cut, dance, decide, drink, drive, eat, enter, escape, exercise, fall, find, finish, fold, follow, forget, forgive, freeze, give, go, grow, help, hide, hit, hold, imagine, increase, inform, invite, jump, keep, kick, kill, know, laugh, lead, learn, leave, listen, live, look, lose, love, make, meet, miss, move, need, open, paint, play, push, put, read, run, say, see, sell, send, set, shake, shoot, show, sing, sit, sleep, smile, speak, spend, stand, start, stay, stop, study, talk, teach, tell, think, throw, touch, travel, try, turn, understand, use, wait, wake, walk, want, watch, wear, win, wish, work, worry, write
Weather: breeze, cloud, cold, fog, hail, heat, lightning, rain, snow, storm, sun, thunder, wind
Body Parts: arm, back, chest, ear, eye, face, foot, hand, head, leg, mouth, neck, nose, shoulder, stomach, teeth
Transportation: airplane, bicycle, boat, bus, car, helicopter, motorcycle, ship, train, truck
Clothing: blouse, boots, coat, dress, gloves, hat, jacket, jeans, pants, shirt, shoes, skirt, socks, sweater, tie
Animals: cat, dog, elephant, fish, giraffe, lion, monkey, panda, rabbit, snake, tiger, whale, zebra
Sports: baseball, basketball, football, golf, soccer, swimming, tennis, volleyball
Technology: computer, internet, laptop, mobile, phone, software, tablet, website
Music: guitar, keyboard, microphone, piano, singer, song, trumpet, violin
Travel: beach, camping, destination, hotel, passport, sightseeing, suitcase, ticket, vacation
Emotions: anger, fear, joy, love, sadness, surprise, disgust
Food: apple, banana, bread, cheese, chicken, chocolate, coffee, cookie, egg, milk, orange, pizza, rice, sandwich, tea
Household Items: chair, clock, curtains, lamp, mirror, pillow, rug, table, vase
Jobs: chef, doctor, firefighter, nurse, police officer, teacher, engineer, scientist
Objects: book, camera, keys, phone, scissors, sunglasses, umbrella, wallet, watch
Places: airport, beach, city, park, restaurant, school, store, zoo
Shapes: circle, square, triangle, rectangle, oval, hexagon
Seasons: spring, summer, autumn, winter
time_and_sequence: after, already, anytime, before, birthday, born, breakfast, early, end, evening, ever, late, lately, morning, night, now, old, period, recent, return, since, soon, still, today, tomorrow, tonight, yesterday
location_and_direction: above, across, along, around, away, behind, below, besides, between, border, corner, east, entrance, front, ground, here, inside, into, island, left, middle, near, nearly, neither, next, north, off, on, opposite, out, outside, over, own, place, road, round, safe, same, sand, seat, second, shade, shadow, shape, share, short, side, sink, six, size, since, sink, skin, sky, south, space, square, stand, state, still, store, street, surface, swing, table, tall, there, thick, thin, through, throw, today, tonight, top, touch, tree, trouble, trunk, turn, under, until, up, upper, very, wall, want, warm, waste, way, west, wet, white, wide, window, winter, within, without, woman, wood, word, world, year, yellow, young
people_and_relationships: anyone, bear, best, brave, child, children, common, couple, each, everybody, everyone, female, gentleman, god, good, hello, her, him, his, husband, king, lady, male, man, many, member, million, mistake, model, moment, my, name, neighbour, nobody, none, other, our, parent, partner, people, person, prince, prison, private, prize, pupil, queen, same, serve, seven, several, sex, she, sheep, shelf, single, six, skill, skin, society, someone, something, spouse, square, stranger, such, tall, their, them, themselves, there, these, they, this, those, three, through, trouble, trunk, turn, us, wall, want, warm, waste, way, wet, white, wife, without, woman, wood, word, year, yellow, young, yourself
actions and activities: active, activity, appear, ask, begin, breathe, bring, call, care, carry, chase, come, complete, continue, control, crash, cross, destroy, develop, do, draw, dream, drop, earn, eat, enjoy, explain, fail, feed, feel, fight, fill, find, fix, fly, follow, form, free, get, give, go, happen, hate, hear, hurt, invent, join, knock, lend, let, lie, light, like, listen, lock, look, lose, love, make, meet, mind, mistake, mix, move, need, offer, open, order, pass, pay, pick, play, point, pour, press, prevent, produce, protect, provide, pull, punish, question, receive, record, remember, remind, remove, repair, repeat, reply, report, rest, result, return, rise, rob, rule, rush, sail, save, search, serve, shout, sick, signal, silence, sink, six, skill, skin, sleep, smell, smile, smoke, speak, spend, spread, stand, start, stay, stop, study, succeed, suggest